VEGFA1_on	CCCAGCTTCCCTGTGGTGGCCGAGCGCCCCCTAGTGACTGCCGTCTGCACACCCCGGCTCTGGCTAAAGAGGGAATGGGCTTTGGAAAGGGGGTGGGGGGAGTTTGCTCCTGGACCCCCTATTTCTGACCTCCCAAACAGCTACATATTTGGGACTGGAGTTGCTTCATGTACAGAGAGCCCAGGGCTGGGCACAGGGGCCA	GGGTGGGGGGAGTTTGCTCC
VEGFA1_1	CTGGGGATTACAGGCATGAATCACTGCACCTGGCCATCATCCTTCTATTTCTTAGGAGGTTGGGTGTGCACATCTAAGGACGGATTTGTGGGATGGAGGGAGTTTGCTCCTGGGGTGTCAGAATGTCCTGTCTGAGACATTAGCATTCAGTAAGTATCTGTTGAATGAATGCTTACAGTTGACTCAGTGGGTCTGCTGTGTA	GGATGGAGGGAGTTTGCTCC
VEGFA1_2	GTGCGTCAACCAGAAACACTCAATAACAAGGCTCCCAGGGACCCTGGGTTCTGAGGCAGAGATGGCAGGGACCACAGTGCTGCAGGAGTTTAGTGGAGGGAGCTTGCTCCTGGCTGGCTGGAGGGCAGCTCAGCTTCCTGGATGGAGGAAGCAGGCCTGTATGGCGGGCTGGGGCTCAGGCAGAACACTCCATGGAGCCCAG	TAGTGGAGGGAGCTTGCTCC
VEGFA1_3	GTACTAAAGCTAGTAGTTCTCTAAAGAGAGCAAGTTTGTTCCCCAGGGGACATTTGGCAATGTCTTGAGACATTTTTGCTGTCACAACTCGGGGAGGGGAAGTTTGCTCCTGGCATTCAGTGGGTAGAGTCCAGCGATGCTGCTAAACATCCTACAATGTACGGTACAGCTGCAGGACAACTCCCACAACAAAGAATGATCT	GGGGAGGGGAAGTTTGCTCC
VEGFA1_4	TGTCAGAGGGACCTGGGCAGGAACACCCGCCACAGTCGTGTCATCTTGTTTGTGCCCCGGTTCATCCTCCCGGAGCCGGCCCTTCCATCCCCAGGAGCAAACTCCACCCTCCCTATCATAATGGGCTGACCAGGGCCAAATTGGTTTCATGAAAAGGAGACACCTGCAGGCAGAGCCCAGCGGACACTCGGTTGTCTGAAGT	CCAGGAGCAAACTCCACCCT
VEGFA1_5	GGCTCAGATGTGGCCCTGAGAGAGCTGATGAAGCTGGCGCCCCGGTACAAGGTGAGCCTGGGTCTGTTCCCTGTGGGGATCACAGGTTCCCCAGGAGCAAACTCCCTCCCCCGTGATGGGAGCCTCTCTCCAGGCAAGCCAAGCCCAGAGCTGGGGTGGGGCCCCTCCATCACTGCCCAAGAAGTGCAGGTGCTGAGCAGGG	CCAGGAGCAAACTCCCTCCC
VEGFA1_6	CTGTTGGTAGCACAGTGGGGCCTGCAACGCAGGCCTCCTGCTCAGTCCAGAGCTCTTCTGACTACAGAGGGTCCTTTGACAAAAGGAAAGGTGGGGGTAGAGTTTGCTCCAGGTGTCAGAAAAGACCAAATGAGACCAGTCCAGGAGGGAATTCATGTTAGCCGGACAGTCTCTGGTGCTAGGGCTTTCCACGGTCTTCCAG	GTGGGGGTAGAGTTTGCTCC
VEGFA1_7	TTAGGCAGAAGGAATTGAGTGATCAGATCAACCAGTCCTCTGGCCTCTAGCCCCATCAACACAGACCTGCCTTAGGGCTGGGAAGATTGCTGGTGGGGGAGCTTGCTCCAGGGAAGGAATGGAAGAAATGCTGGAGGCTAAGCCTGTCATTTGTTAGCATATTCATAGTCAGATGGCCAAATTAGGACACAACCAAGGTTG	TGGTGGGGGAGCTTGCTCC
VEGFA1_8	GTGCGGTGGGGGTGCTGGAGGCAGGGCAGCTGTGGAATGTAGGGCTGAGAGCATGCATTCCTGCTTCTCCACCCAGACTCCTGGTGTGGCCTGGGGCAAACTCCCCCCACCCACCGCCCCCCGTGGCTGGGCCTCAGATTCCCCAGCCTTAGAACGAGAGGGCTGGAGTCAGACATCTGTGGACTCTGGTGATGCCATCAG	CTGGGGCAAACTCCCCCCA
VEGFA1_9	AGGAGGATTTTGCTGTCAACCTAGAAGTTTCACCTGAGATCTGGGGAAAGAAAGCCCCACCCTCGCTCTTTTAGTCTCTTACCTCATTGCCCGGGAGCAAACACCCCCCACGCATAAAACTCAGTCTTGGTCTCTGAAAATGTAGGCATAGGCATCTCTGCTTAGCTTTGCAGTAGATAAAACAAAAGCAGTTAATATGTAA	CCGGGAGCAAACACCCCCCA
VEGFA1_10	TCTCTGTTGACCTGTAGAGACCCCTCCTCAGAGGGTGCTGTCTGTCTTTGTGCCCACTGCACTGAAACATCTCACCCAAGCCTTCCTGTGCCAGGAGCAAACTGCCCCCCCAAATCCTGGGCACGGGGCCTTCCCTGCAGAATCGCATGTTCCCTTGTTTATGAGGGGCAGGCTGGAACAGGCCCCTTGAGCAGGCAGGGGG	CCAGGAGCAAACTGCCCCCC
VEGFA1_11	TGGTGGGGAGGTGGCAACGGTGATGGCGACGAAAGAATAAGGCACCTGCCATTGGCCCTTGGGAGCAGGTCTTGTGGGTGACAGGCTTCAGAGGGGGAGCAGTTTGCTCCAGGTGACACATGTCGCCACACTCCCAAGCCTGTCATCTGCAGTTAGGGCTGAGGCCACCACTGACAGGTTCCAGATGGCTCAGTCCATCTGA	GAGGGGGAGCAGTTTGCTCC
VEGFA1_12	AATGGGAGTTGCAGGTGGGCTAGGAGAGGCAGGCAGTGCATGGGTGTGCTACCTAGCATGGCGCCTCTCACAAGCCAGAGCCAGGGCAAACCTGGAGCAGACTCCCCTCCTCCCCTGCAAGCTAGTTAACTACACATTCCCATGTCCTACCCACACATTCGAATTCCATGGGCCTGGGGTGGGACCCAAGGACTTTTTTTTC	CCTGGAGCAGACTCCCCTCC
VEGFA1_13	CTGTGCCTCTGTAAGTCAATCCTCCTTTGGGGTGTGGCCAGGAGGAAGCCCTCTGTCCCCCTCTTCTGTATATTCCCCTCTGTCAATATAAGGCAGAGGGAGATTGCTCCAGGGTAAGTTACAGCCACCCGGAGGCTGGAGCCCTTAAAAGGCTTGGCTCAGGGTAGAGCAGAGGACACTGCCAGTGGAACAGGGGAATGGC	AGGCAGAGGGAGATTGCTCC
VEGFA1_14	TGATTCTGAATTGGGGGCAGTTTTGACCACTGGAGACATTTGGCAATGCCTGGAGACATTCTTGGTTGTCATAACTGGGGGCATGATCGGGTGGGGGTGGGTTTGCTCCTGGTATCTAATGGGTAGAGGCCAGAGATGCTGCCACAGTACACACATGACAACATCCCTGGCCCTCCCCCCACCCTCCAACAAATAATTATC	GTGGGGGTGGGTTTGCTCC
VEGFA1_15	GGGAGGTCCATGCTGAAGATCCCATACCTCCATTACCTCTTCCTCCCCACCGTCTGTTCTCACCACTCCATGAGCCCTTGCTACATTTGGGGGCAAGGGGAGGTTGCTCCTGGAGACTAACTAGATTCCATTTGTAAAGAGGCACCCTTGTCAAGGTCTCTGTTTGACTTAGCAACTCATTTGTCAGAAGACCAGCTAAGAA	GGGCAAGGGGAGGTTGCTCC
VEGFA1_16	CACAGAAGGATGTGTGCAGGTTATATGCAAATACTACACAATTTTATATTAGAGACTTGATCAACTGAGGATATTGGTATCCACAGGGGCCCTGGAGCAAATTCCCCACACATACAAACGGATGGCAGTACTGGAAATAATCCATCGAATAGTCAATCAGTAGGATAAAACAGGTTAAATAAGTTGCAGTAGACTTATATTA	CCTGGAGCAAATTCCCCACA
VEGFA1_17	TCACTTTTTCCTTGAGGGCGATTGCCAGTGTCAGAAGAGGTGGCTGAGGGCTGAGCGGTGCTTTCGCAGATTGTGAGGATAACGGAGAGAAGGTGGTGGGAGCTTGTTCCTGGCTTGCATTTTTGGTTGGGACCGCGCAGCACTACACCCGGGCATACGGGTGGACTGGAGACCTGCACCAGTCCTGGCGAGATTTGCTGCT	AGGTGGTGGGAGCTTGTTCC
VEGFA1_18	TAAAATGGTAAAAATTGGTGAATTTTGTGCAATGTGTATTTTACCATAATAAGGAAAAAAGTATGTACCACAGTAGGTCATTGGTTGGGTAAGTAAGGGAAGTTTGCTCCTGGTCCCTGCTGGGCACTGTGCATTAGCCCTGTACATAGTTGTACTAGTTTCACCAAACTATCTGCTTGATTGTGAGAGGTGGGCCAGAGCT	AAGTAAGGGAAGTTTGCTCC
VEGFA1_19	GCCTCAGAGTCTTAACTTGTTCCAGCATCAACTCAAAAGTCTGAAGTCTCATCTAAATCAGATATGGTTGAGACTCAAGGCCTGATTCACCTGGGGCAAACTCCCTCCAGCTCTAAGTTTGTGAAATCAAAACAAGTTATCTACTTCCAAAACACAATAGTGGGACAGACACAGGATAGACATTCCCATTCCAAAATAGAG	CTGGGGCAAACTCCCTCCA
VEGFA1_20	ACACAATAACTTTGAACTAAAATAATTATATTTTTGTTGTTTTCCACTCTGTCCCCACGTCTATATCACCACCACCCCCAATTCCGCCCCCCAGGAGCTAACTCCTCCTTCCTGTCCCTGCAAGATTAAAACTCCTCCTGGAAGCCCCGCTAGCTCTGTCTGCTCGCCTTCGTGGCAGATATCGCTATTGTACTTTTATACT	CCAGGAGCTAACTCCTCCTT
VEGFA1_21	GGACTTGGAGGTAGGTGTTCAGGTCAGAAGGGACAGTCCTGACTTCCTCCACCGCTGTCTGCAGAAGCAGAGGCTGAAGCCACAGGCTGCGGGGGTGGGGAGCATGCTCCAGGAAGTGGCTCTCGGTGCTCCTGTCCACAGCCTCTGCAAGGAGAGGCACAGGCCCAGGCAAAGAACACAGTATGGCAAGTGAGGAGAAGGG	GGGGGTGGGGAGCATGCTCC
VEGFA1_22	AAACTCATAGAACAAAGGATCCTCCCTCCTAGGCCTGGGCGTGGGCTCGCAGAATGCTGGGATTCCCAGATTACAGGCCGGTGCACCACACCAGGAGCAAACACTTCCCACTTTAAAAATTCAGTTTGTGATTGGCTGTCATTCAGTATTATGCTAATTAAGCATGCCTGTTTTTAAACTTCTTAAAACAATTTTTTAAAAT	CCAGGAGCAAACACTTCCCA
VEGFA1_23	GAGCAGCGGCCACCTCAGGCCAACTGCTCTGGAGGGGATGTGCACCTGCGTCCTGCTAAACACTGGTGCACTGCCAGGCATGGAGGGCTCAGCAGGGGGGAGTCTGCTCCCTGGGAGGGTGCTGATCTGTTCTTCCTGCTTTCCGTTACATTCCTTTGAAGCCTTGAGACCAGCAAGTCTAGCCTCAGCCCCACTTCTCCCT	AGCAGGGGGGAGTCTGCTCC
VEGFA1_24 GTTTCCCATTCCTCCGCCTCATTCGCTCCAGCTCCCCCGGCTCCTAGCTCCATCTCTGCTCTGGATGTTGTTGTTATTTTGTGGCTGGGCCAGGGAGCAAACTCTCCCCTCTTCTACGACCTGCAGGGTGGGGGCCCAAGCTGGATTCAGGCCTCTGCCAGGACCTAAGCCTCTGAAGAGTGTGGGGAAGCAGTGGTGATGA	CAGGGAGCAAACTCTCCCCT
